1111111111
100000PEC1
100000C001
1000000001
1111111111
