111111111111111
10000000000P001
1000000E0000001
1000C000C000001
111111111111111
