1111111111111111111111111111111111111111111111
10P000000000000000000000010000C000000000000001
1111111110111111110000000111111111111000000001
10C10000101000001000000000000000000000C0000001
10C1000010100000100100111111111111111111111111
1001000100100000100100100000000000000000000001
10010000000000001001001000C000000000000000E001
10010000010000001C01C0100000000000000000000001
10C0000001000000100100100000000000000000000001
1111111110000000111111100000000000000000000001
10C00000000000000000000000000000C0000000000001
1111111111111111111111111111111111111111111111
