111111111111111
100000000000001
100CC00000E0001
100000000000001
100P00000000001
100000000000001
1000C0000000001
100000000000001
1000C0000000001
100000000000001
111111111111111
