111111111111111
10000000000P001
1000001E1000001
1000C001C000001
111111111111111
