111111111111111
10000000000P001
1000000E0000001
100000C0000C001
111111111111111
